[{
		"viewPortX": 1600,
		"viewPortY": 896,
		"roomX": 1600,
		"roomY": 896,
		"speed": 0,
		"tilesMap": [
			[0, 1, 1, 1, 1, 1, 0, 1, 1, 1, 1, 1, 1, 1, 1, 1, 1, 1, 0, 1, 1, 1, 1, 1, 0],
			[11, 16, 16, 16, 16, 16, 8, -1, -1, -1, -1, -1, -1, -1, -1, -1, -1, -1, 5, -1, 16, -1, -1, -1, 3],
			[11, 16, 16, 16, 16, 16, 8, 16, 9, 16, 16, -1, 16, 16, 6, 16, 16, -1, 16, -1, 9, -1, -1, -1, 3],
			[11, 16, 7, 2, 13, 16, 8, 16, 4, 2, 14, -1, 6, 16, 16, 16, 6, -1, 10, 2, 1, 13, -1, -1, 3],
			[11, -1, -1, -1, -1, -1, 8, -1, -1, 16, 8, -1, 16, 16, 6, 16, 16, -1, 8, 16, 16, 16, 16, 16, 3],
			[11, -1, -1, -1, -1, -1, 4, 2, 13, 16, 8, -1, -1, -1, -1, -1, -1, -1, 8, 16, 16, 16, 16, 16, 3],
			[11, 16, 16, 16, 16, 16, -1, -1, -1, 16, 3, 2, 2, 2, 2, 2, 2, 2, 11, 16, 16, 16, 16, 16, 3],
			[0, 2, 2, 2, 2, 2, 2, 2, 2, 2, 12, -1, -1, -1, -1, -1, -1, 18, 8, -1, -1, -1, 19, 19, 3],
			[11, -1, -1, -1, -1, -1, -1, -1, -1, -1, -1, -1, -1, -1, 16, 16, 2, 2, 12, 16, 16, 7, 2, 2, 0],
			[11, -1, -1, 16, -1, -1, -1, -1, -1, -1, -1, -1, -1, 9, 19, 16, -1, -1, -1, 16, 16, -1, -1, -1, 3],
			[11, -1, -1, 9, -1, -1, -1, -1, -1, -1, 6, -1, -1, 4, 13, -1, -1, -1, -1, 16, 16, -1, -1, -1, 3],
			[11, 18, 18, 8, -1, 6, -1, -1, -1, 16, 16, 16, -1, 16, 16, -1, -1, -1, -1, 16, 16, -1, -1, -1, 3],
			[11, 18, 18, 8, -1, 16, -1, -1, 16, 16, 19, 16, 16, 16, 16, -1, -1, -1, -1, 16, 16, -1, -1, -1, 3],
			[0, 15, 15, 0, 15, 15, 15, 15, 15, 15, 15, 15, 15, 15, 15, 15, 15, 15, 15, 15, 15, 15, 15, 15, 0]
		]
	}, {
		"viewPortX": 1600,
		"viewPortY": 896,
		"roomX": 3200,
		"roomY": 896,
		"speed": 5,
		"tilesMap": [
			[0, 16, 16, 16, 16, 16, 16, 16, 16, 16, 16, 16, 16, 16, 16, -1, -1, -1, -1, -1, -1, -1, -1, -1, -1, -1, -1, -1, -1, -1, -1, -1, -1, -1, -1, -1, -1, -1, -1, -1, -1, -1, -1, -1, -1, -1, -1, -1, -1, 0],
			[16, 16, 16, 16, 16, 16, 16, 0, 0, 0, 0, 0, 16, 16, 16, -1, -1, -1, -1, -1, -1, -1, -1, -1, -1, -1, -1, -1, -1, -1, -1, -1, -1, -1, -1, -1, -1, -1, -1, -1, -1, -1, -1, -1, -1, -1, -1, -1, -1, -1],
			[16, 16, 16, 16, 16, 16, 16, 16, 16, 16, 16, 16, 16, 16, 16, -1, -1, -1, -1, -1, -1, -1, -1, -1, -1, -1, -1, -1, -1, -1, -1, -1, -1, -1, -1, -1, -1, -1, -1, -1, -1, -1, -1, -1, -1, -1, -1, -1, -1, -1],
			[16, 16, 16, 16, 16, 16, 0, 0, 0, 0, 16, 16, 16, 16, 16, -1, -1, -1, -1, -1, -1, -1, -1, -1, -1, -1, -1, -1, -1, -1, -1, -1, -1, -1, -1, -1, -1, -1, -1, -1, -1, -1, -1, -1, -1, -1, -1, -1, -1, -1],
			[16, 0, 0, 0, 0, 16, 16, 16, 16, 16, 16, 16, 16, 16, 16, -1, -1, -1, -1, -1, -1, -1, -1, -1, -1, -1, -1, -1, -1, -1, -1, -1, -1, -1, -1, -1, -1, -1, -1, -1, -1, -1, -1, -1, -1, -1, -1, -1, -1, -1],
			[16, 16, 16, 16, 16, 16, 16, 16, 16, 16, 16, 16, 16, 16, 16, -1, -1, -1, -1, -1, -1, -1, -1, -1, -1, -1, -1, -1, -1, -1, -1, -1, -1, -1, -1, -1, -1, -1, -1, -1, -1, -1, -1, -1, -1, -1, -1, -1, -1, -1],
			[16, 16, 16, 16, 16, 16, 16, 16, 16, 16, 16, 16, 16, 16, 16, -1, -1, -1, -1, -1, -1, -1, -1, -1, -1, -1, -1, -1, -1, -1, -1, -1, -1, -1, -1, -1, -1, -1, -1, -1, -1, -1, -1, -1, -1, -1, -1, -1, -1, -1],
			[16, 16, 16, 16, 16, 0, 0, 0, 0, 16, 16, 16, 16, 16, 16, -1, -1, -1, -1, -1, -1, -1, -1, -1, -1, -1, -1, -1, -1, -1, -1, -1, -1, -1, -1, -1, -1, -1, -1, -1, -1, -1, -1, -1, -1, -1, -1, -1, -1, -1],
			[0, 0, 0, 16, 16, 16, 16, 16, 16, 16, 16, 16, 16, 16, 16, -1, -1, -1, -1, -1, -1, -1, -1, -1, -1, -1, -1, -1, -1, -1, -1, -1, -1, -1, -1, -1, -1, -1, -1, -1, -1, -1, -1, -1, -1, -1, -1, -1, -1, -1],
			[16, 16, 16, 16, 16, 16, 16, 16, 16, 16, 16, 16, 16, 16, 16, -1, -1, -1, -1, 16, 16, 16, 16, 16, 16, 16, 16, 16, -1, -1, -1, -1, -1, -1, -1, -1, -1, -1, -1, -1, -1, -1, -1, -1, -1, -1, -1, -1, -1, -1],
			[16, 16, 16, 16, 16, 16, 16, 16, 16, 16, 16, 16, 16, 16, 16, 16, 16, 16, 16, 16, 16, 16, 16, 16, 16, 16, 16, 16, 16, 16, 16, 16, 16, 16, 16, 16, 16, 16, 16, 16, 16, 16, 16, 16, 16, 16, 16, 16, 16, 16],
			[16, 16, 16, 16, 0, 0, 0, 0, 0, 0, 0, 0, 0, 0, 0, 0, 0, 0, 0, 0, 0, 0, 0, 0, 0, 0, 0, 0, 0, 0, 0, 0, 0, 0, 0, 0, 0, 0, 0, 0, 0, 0, 0, 0, 0, 0, 0, 0, 0, 0],
			[16, 16, 16, 16, -1, -1, -1, -1, -1, -1, -1, -1, -1, -1, -1, -1, -1, -1, -1, -1, -1, -1, -1, -1, -1, -1, -1, -1, -1, -1, -1, -1, -1, -1, -1, -1, -1, -1, -1, -1, -1, -1, -1, -1, -1, -1, -1, -1, -1, -1],
			[0, 0, 0, 0, -1, -1, -1, -1, -1, -1, -1, -1, -1, -1, -1, -1, -1, -1, -1, -1, -1, -1, -1, -1, -1, -1, -1, -1, -1, -1, -1, -1, -1, -1, -1, -1, -1, -1, -1, -1, -1, -1, -1, -1, -1, -1, -1, -1, -1, 0]
		]
	}, {
		"viewPortX": 1600,
		"viewPortY": 900,
		"roomX": 3200,
		"roomY": 896,
		"speed": 1,
		"tilesMap": [
			[0, 1, 1, 1, 1, 1, 1, 1, 1, 1, 1, 1, 1, 1, 1, 1, 1, 1, 1, 1, 1, 0, 1, 1, 1, 1, 1, 1, 1, 1, 1, 1, 1, 1, 1, 1, 1, 1, 1, 1, 1, 1, 1, 1, 1, 1, 1, 1, 1, 0														],
			[11, 16, 16, 16, 16, -1, -1, -1, -1, 16, 16, -1, -1, -1, -1, 16, 16, -1, -1, -1, -1, 8, -1, -1, -1, 16, -1, -1, -1, -1, -1, 16, 16, -1, -1, 21, 21, -1, -1, 16, 16, -1, -1, 21, 21, -1, -1, -1, -1, 3		],
			[	11, 16, 16, 16, 16, -1, 17, 17, -1, 16, 16, -1, 17, 17, -1, 16, 16, -1, -1, -1, -1, 8, -1, -1, -1, 6, -1, -1, -1, -1, -1, 19, 19, -1, -1, 16, 16, -1, -1, 19, 19, -1, -1, 16, 16, -1, -1, -1, -1, 3],
			[	11, 16, 7, 13, 16, 10, 2, 2, 2, 2, 2, 2, 2, 2, 2, 2, 2, 2, 13, 16, 16, 5, -1, 6, -1, -1, -1, 7, 2, 2, 2, 2, 2, 2, 2, 2, 2, 2, 2, 2, 2, 2, 2, 2, 2, 2, 13, 16, 16, 3],
			[	11, -1, -1, -1, -1, 8, -1, -1, -1, -1, 16, -1, -1, -1, 16, -1, -1, -1, -1, -1, -1, 16, -1, -1, -1, -1, -1, -1, -1, -1, -1, 16, 21, -1, -1, -1, -1, -1, -1, 16, -1, -1, -1, -1, -1, -1, -1, -1, -1, 3],
			[	11, -1, 6, -1, -1, 8, -1, -1, -1, -1, 9, -1, -1, -1, 6, -1, -1, 16, -1, -1, -1, 6, 16, 16, 16, 16, -1, -1, -1, -1, 16, 16, -1, -1, -1, -1, -1, -1, -1, 9, -1, -1, -1, -1, -1, -1, -1, -1, -1, 3],
			[	11, -1, -1, -1, -1, 8, -1, 7, 2, 2, 11, -1, -1, -1, -1, 16, -1, 6, -1, -1, -1, -1, -1, -1, -1, -1, -1, -1, -1, 19, 16, -1, -1, -1, -1, -1, -1, -1, -1, 3, 2, 2, 2, 14, 16, 7, 2, 13, 16, 3],
			[	11, -1, -1, -1, 7, 11, -1, -1, 16, -1, 3, 2, 13, -1, -1, 6, -1, -1, -1, -1, -1, -1, -1, -1, -1, 16, 16, 7, 2, 2, 2, 2, 2, 2, 2, 2, 13, 16, 16, 8, -1, -1, -1, 8, 16, -1, -1, 16, 16, 3],
			[	11, -1, -1, -1, -1, 8, -1, -1, 16, -1, 8, -1, -1, 17, -1, -1, -1, 17, -1, -1, -1, -1, -1, -1, -1, 16, -1, -1, -1, -1, 16, 21, -1, -1, 16, -1, -1, 16, 10, 12, -1, 8, -1, 3, 13, -1, -1, 7, 2, 0],
			[	11, 16, 16, 16, -1, 3, 2, 2, 13, -1, 8, -1, -1, 6, -1, -1, -1, 6, -1, -1, -1, -1, -1, -1, -1, 16, -1, -1, -1, -1, 16, -1, -1, -1, 16, -1, -1, 16, 8, 16, -1, 8, 16, 8, -1, -1, -1, -1, -1, 3],
			[	11, -1, -1, -1, -1, 8, -1, -1, -1, 16, 8, -1, -1, -1, 16, 16, 16, 16, 16, 17, 17, -1, -1, -1, -1, 16, -1, -1, -1, -1, 16, -1, -1, -1, 16, -1, -1, 16, 4, 14, -1, 8, -1, 12, -1, 16, 9, -1, -1, 3],
			[	11, -1, -1, -1, -1, 5, -1, 9, -1, 7, 0, 2, 2, 2, 2, 2, 2, 2, 2, 2, 2, 2, 2, 2, 2, 14, -1, -1, -1, -1, 16, -1, -1, -1, 16, -1, -1, -1, -1, 5, -1, 8, -1, -1, -1, 7, 11, 18, 18, 3],
			[	11, 17, 17, 17, -1, -1, -1, 8, 16, 16, 16, 16, 16, 16, 16, 16, 16, 16, 16, 16, 16, 16, 16, 16, 16, 8, 16, -1, -1, 19, 16, -1, -1, -1, 19, -1, -1, -1, -1, 16, -1, 8, 16, 16, 16, 19, 8, 18, 18, 3],
			[	0, 15, 15, 15, 15, 15, 15, 0, 15, 15, 15, 15, 15, 15, 15, 15, 15, 15, 15, 15, 15, 15, 15, 15, 15, 0, 15, 15, 15, 15, 15, 15, 15, 15, 15, 15, 15, 15, 15, 15, 15, 0, 15, 15, 15, 15, 0, 15, 15, 0]

			]
		}

	]
